#######################################
#.....................................#
#.....................................#
#.....................................#
#.....................................#
#.....................................#
#.............#..##########...........#
#.............#..#........#...........#
#.............#..#........#...........#
#.............#..#........#...........#
#.............#..#........#...........#
#.............#..#........#...........#
#.............#...........#...........#
#.............#...........#...........#
#.............#...........#...........#
#.............#...........#...........#
#.............#############...........#
#.....................................#
#.....................................#
#######################################