########################################
#......................................#
#......................................#
#......................................#
#......................................#
#......................................#
#.............#..##########............#
#.............#..#........#............#
#.............#..#........#............#
#.............#..#........#............#
#.............#..#........#............#
#.............#..#........#............#
#.............#...........#............#
#.............#...........#............#
#.............#...........#............#
#.............#...........#............#
#.............#############............#
#......................................#
#......................................#
########################################